....#####.............
....#...#.............
....#$..#.............
..###..$###...........
..#..$..$.#...........
###.#.###.#.....######
#...#.###.#######..OO#
#.$..$.............OO#
#####.####.#@####..OO#
....#......###..######
....########..........