############..
#OO..#.....###
#OO..#.$..$..#
#OO..#$####..#
#OO....@.##..#
#OO..#.#..$.##
######.##$.$.#
..#.$..$.$.$.#
..#....#.....#
..############