........########.
........#.....@#.
........#.$#$.##.
........#.$..$#..
........##$.$.#..
#########.$.#.###
#OOOO..##.$..$..#
##OOO....$..$...#
#OOOO..##########
########.........