########
###...##
#.$.#.##
#.#..O.#
#.@..#.#
##.#...#
##...###
########